1111111111
1000E01011
10000010C1
1010C01001
100C001011
1000001011
10010P1011
100C001011
1111111111