1111111111
1000E01011
1000001001
1010001001
1000001011
1000001011
10010P1011
1000000011
1111111111